X______X
X_XXS__X
___XXX__
X______X
__XXXX__
X__X___X
__G__X__
X__X___X